111111111111111111111111
1C00000000000000001C00E1
111111000010001000100001
100000000010001000000001
100100011110001110000001
1P0100000010000C11000001
111111111111111111111111