1111111111111111111
10000000000001C00Q1
1000000001000100001
1000000001000000001
1001000000100000001
1P01000000C11000001
1000000000000000001
1000011111000000001
1000010C01000000001
1111111111111111111